150
((((((((((((((((((((((((((((((((((((((((
(|||||||||!!!!n!n!!n!!!!!!!!n!|||||||||(
(|        !!!!!!!!!!!n!!!!n!!!        |(
(| *%     !!n!!!!!!!!!!n!!!n!!      %*|(
(|||||||||!!n!!!!!!!!n!!!!!!n!|||||||||(
(|        !!!!!!n!!!n!!!!!!!n!        |(
(| *%     !!!!n!!!!!!n!nn!!!!!      %*|(
(|||||||||!nn!!!!!!!!n!nn!!!!!|||||||||(
(|        !!!!n!n!!!!n!!n!!!!!        |(
(| *%     !!!!n!n!!!!n!!n!!n!!      %*|(
(|||||||||!nn!n!!n!!!!!!!!n!!!|||||||||(
(|        !nn!n!!n!!!!!!!!!!!!        |(
(| *%     !!!!n!!n!!!!!!!!n!!!      %*|(
(|||||||||!!!!!n!!!n!!!!n!!n!!|||||||||(
(!!!!n!n!!n!!!!!!!!n!!!!!n!!!!!!!!!!!!n(
(!!!!!!n!!!n!!!!n!!!n!n!!!n!!n!!!!!!!!!(
(!!n!!!!n!!!!n!!!n!!!!!!!!n!!n!!!!!!!!!(
(!!n!!!!!!!n!!!!!!!n!nn!!!!!!!!!n!!!!!!(
(n!@!!!n!!!!!!!!!!!n!nn!!!!!!!!!nn!!n!((
(!!!!!n!!!!n!nn!!!!!!!n!!!!!!!!n!!n!!!!(
(nn!!!!!!!!n!nn!!!!!!!!!!n!!n!n!n!!n!!!(
((((((((((((((((((((((((((((((((((((((((