150
((((((((((((((((((((((((((((((((((((((((
(;;;;;;;;;;;@;;;;;;;;;;;;;;;;;;;;;;;;;;(
(|||||||||||;|||||||;;;;;;;;;;;;;;;;;;;(
(|;;;;;;;;;; ;;;;;;|;;;;;;;;;;;;;;;;;;;(
(|;|%|;|||||;|||||;|;;;;;;;;;;;;;;;;;;;(
(|;|%|;|*;;; ;;;;;;|;;;;;;;;;;;;;;;;;;;(
(|;|%|;|;|||;;|||;;|;;;;;;;;;;;;;;;;;;;(
(|;|*|;|;|;;;;;;|;;|;;;;;;;;;;;;;;;;;;;(
(|;|%|;|;|;|;;|;|;;|;;;;;;;;;;;;;;;;;;;(
(|;|%|;|;|;|;;|;|;;|;;;;;;;;;;;;;;;;;;;(
(|;|%|;|;|;|;;|;|;;|;;;;;;;;;;;;;;;;;;;(
(|;|%|;|;|;|;;|;|;;|;;;;;;;;;;;;;;;;;;;(
(|;|%|;|;|;|;;|;|;;|;;;;;;;;;;;;;;;;;;;(
(|;|%|;|;|;|;;|;|;;|;;;;;;;;;;;;;;;;;;;(
(|;|*|;|;|;|;;|;|;;|;;;;;;;;;;;;;;;;;;;(
(|;|*|;|;|;|;;;;;;;|;;;;;;;;;;;;;;;;;;;(
(|;|*|;|;||||||||;;|;;;;;;;;;;;;;;;;;;;(
(|;|*|;;;;;;;;;;;;;|;;;;;;;;;;;;;;;;;;;(
(|||||||||||||||||||;;;;;;;;;;;;;;;;;;;(
(;;;;;;;;;;;;;;;;;;;;;;;;;;;;;;;;;;;;;;(
(;;;;;;;;;;;;;;;;;;;;;;;;;;;;;;;;;;;;;;(
((((((((((((((((((((((((((((((((((((((((