40 22
120
((((((((((((((((((((((((((((((((((((((((
(; ;; ;nn;;;;; ;; ; @;;;; n   ;;n; ;  ;(
( ;;n; ;; ;  ;;;; ;n; ; ;;; nn;;n;*;; ;(
(n;;;;;  ; ;  ;;;n;n;n; ;;;n|||||||||||(
(;n;*;;; ;% ;;;;;; ;;nn;; ;;;; ; ;;; ; (
(||||||||||||; ; ;;  nn;; ;;;; ;;;n;;;;(
(n;  ;;;;;; ;;n; ;;; ;; ;n ;;n;  %;;;;;(
(n;n ;;;;;; ;;nn;; ;;;;n;;;n;;;;;; ;n ;(
(;;; ;;n  ;;; ;; ;n ;;n;  ;;; ;;;; ;nn;(
(;;;n;;n; ; ;;;;n;;;%;;;;;;n;n;;   ;;n;(
(  ;;  ;;;; ;;n;n;;;; ;  ;;;;;;; n ;;n;(
(; ;;;n;; ;n ;; ;  ;;;;;    ;; ; ;n ;; (
(;;  ;;n;n;;;; ;  ;;;;;;n   ;;n; ;*n;;;(
(;n;* ;; ;  ;;; ; ; ; ;;;nnn;;n;;;;n;;;(
(;;;;  ; ;  ;;; ;n;n; ; ;n;n ;; n;;;; ;(
(;  ;;;;n;;;;  ;;n n ;; ;;;;n;;;n;;; ;n(
(;;;;; ;n ;n ; ;;;nnn;;n;n;;;  ;;n;n;;;(
(  ;;;;;; ;;n; ; ;;;; ;n ;;n; nn;;;;;;;(
(n ;;;;;; ;;nn;;n;;;; ;;;n;;;;;;n;nn;;;(
(; ;;n; ;;; ;; ;n ;??;  ;;; ;;;;n;nn;;;(
(;n;*n%;;n;;;;n;;;n??;;;;n;n%;;;;;*n;;;(
((((((((((((((((((((((((((((((((((((((((